Almost = neredeyse
Avenue = cadde
Director= yönetmen
East = doğu
West = batı
North = kuzey
South = güney
Unemployed = işsiz
Introduction = giriş
Description = tanım
Overview = genel bakış
Feature = özellik
Support = Desteklemek
instruction = talimat
enchance = geliştirmek
as well as = ayrıca
Extensive = geniş
Layer = katman
internal = iç
External = dış
Access = erişim
Neighbour= komşu
Too= ayrıca
Predict = tahmin etmek
Remarkably = önemli ölçüde
Competitive = rekabet
Temporary = geçici
Constantly = sürekli istikrarlı
Precision = hassasiyet
Cache = önbellek
Domain = alan
Interface = arayüz
Flexible = esnek
Tamper = kurcalamak
Seperate = ayrı
Steady = sabit
Balance = denge
Unbalance = dengesizlik
Difference = fark
Distortion = bozulma
Crest = tepe
Peak = zirve
Amplitude = genlik
Utilization = kullanım
Relationship = ilişki
Steady = sabit
Fairly = oldukça
Rich = zengin
Important = önemli
Topic = konu
Letter = mektup
on foot = yürüyerek
Afraid = korkmak
Depend = bağımlı olmak
Meal = yemek
Rich = zengin
Therefore = bu yüzden
Move = hareket etmek
Pick up = toplamak
Construction = inşaat
Different = farklı
Lead to = sebep olmak
During = süresince
Ordinary = sıradan
Provide = sağlamak
Rather = oldukça
Entirely = tamamıyla
Intelligent = akıllı
Require = gerektirmek
